#########################################
#         #           # #       #     # #
# ### ##### # ####### # # ##### # # # # #
#   #       #     # # #   #   #   # # # #
### ############# # # ##### # ##### # # #
#             #   #         #       # # #
# ############# ### ################# # #
#   #     #   # #     #   #             #
# ### ### # # # ##### # # # #############
# #   # #   # # #   # # # # #           #
# # ### ##### # # # ### # # # ######### #
# # # #     #   # #     # # #   #     # #
### # # # ##### # ####### # ### # ### # #
#   #   #       # #     # # #   #   #   #
# # ######### ### # ### # ### ##### #####
# # #   #   #   # # # # #   #     # #   #
# # # # # # ### # # # # ### ##### # # # #
# # # #   # #   # # # #   # #   # # # # #
# ### ##### ##### # # ### # # # # # # ###
# #   #   #   #   #     # # # # # # #   #
# # ### # ### # ######### # # # # # # # #
# #   # #   # #     #o  #     # # # # # #
# ### ### # # ##### ### ####### # # ### #
#   #     # #     #   #   #   # # # #   #
# # ### ######### # # ### # # # # # # # #
# #     #     #   # #   # # # # # # # # #
##### ### ### # ### ##### # ### # # # # #
#   # #   # # # #   #     #   #   # # # #
# # # # ### # # # # # ####### ##### # ###
# # # # #   #   # # #   #         # #   #
# # # # # # ### # ##### # # ### ### ### #
# # # # # #   # #       # # #   #   #   #
# # ### # ### # ######### # # ### ### # #
# #   # # #   #       #   # #   #     # #
# ### # # ########### # ### ########### #
# #     #         #   #   #             #
# ######### ##### # ##### ###############
#         #     #       # #   #   #     #
# ####### ############### # # # # # ### #
#       #                   #   #   #@  #
#########################################